....................
....................
..........X.H.......
.......######.......
.CG..............G.C
####..G.G.G.G....###
.......G.G.GCG......
......--------......
...--...........--..
.......--...--......
.G.G............G.G.
####.....C......####
.......######.......
.1..................
####################
