....................
....................
..........X.H.......
.......######.......
..G..............G..
####..G.G.G.G....###
.......G.G.GCG......
......--------......
...--...........--..
....................
.G.G............G.G.
####............####
....................
.1..................
####################
