....................
...G............X...
....-..G.......--...
....G.-.........G...
...-...........-....
...G......G....G....
...-....-.....-.....
....G...........G...
...-......-..G.-....
...G........-..G....
...-...........-....
....G....-......G...
...--...........-...
.1.......H..C..H....
####################
